1111111111111
11110000000C1
1110011111001
1P0011E000011
1111111111111
