1111111111111
1001000P00001
1C00011111001
100011E000001
1111111111111
1111111111111
1001000000001
11111111111111
